42 42
0 0 0 0 0 0 0 0 0 0 0 0 0 0 0 0 0 0 0 0 0 0 0 0 0 0 0 0 0 0 0 0 0 0 0 0 0 0 0 0 0 0
0 0 0 0 0 0 0 0 0 0 0 0 0 0 0 0 0 0 0 0 0 0 0 0 0 0 0 0 0 0 0 0 0 0 0 0 0 0 0 0 0 0
0 0 0 0 0 0 0 0 0 0 0 0 0 0 0 0 0 0 0 0 0 0 0 0 0 0 0 0 0 0 0 0 0 0 0 0 0 0 0 0 0 0
0 0 0 1 1 1 1 1 1 1 1 1 1 0 1 1 1 1 2 2 1 2 1 2 1 1 1 1 1 1 0 1 1 1 1 1 1 1 1 0 0 0
0 0 0 1 2 2 2 1 2 1 2 1 1 C 1 1 2 1 1 1 1 2 1 2 1 2 2 2 1 1 C 1 1 1 1 1 1 E 1 0 0 0
0 0 0 1 1 1 1 1 2 1 2 1 1 0 1 1 2 1 2 2 1 1 1 1 1 2 1 1 1 1 0 1 1 1 1 1 1 1 1 0 0 0
0 0 0 1 2 2 0 0 0 0 0 0 0 0 0 0 0 0 0 0 0 0 0 0 0 0 0 0 0 0 0 0 0 0 0 0 0 0 0 0 0 0
0 0 0 1 2 1 0 0 0 0 0 0 0 0 0 0 0 0 0 0 0 0 0 0 0 0 0 0 0 0 0 0 0 0 0 0 0 0 0 0 0 0
0 0 0 1 2 1 1 2 1 1 1 1 1 1 0 1 1 1 1 1 2 1 2 1 1 1 1 0 1 1 1 1 1 2 1 1 2 1 1 0 0 0
0 0 0 1 2 1 1 2 1 2 2 2 1 1 C 1 1 2 1 1 2 1 2 2 2 1 1 C 1 1 2 1 1 2 1 1 2 2 1 0 0 0
0 0 0 1 1 1 1 1 1 1 1 2 1 1 0 1 1 2 1 1 1 1 1 1 2 1 1 0 1 1 2 1 1 1 1 1 1 1 1 0 0 0
0 0 0 0 0 0 0 0 0 0 0 0 0 0 0 0 0 0 0 0 0 0 0 0 0 0 0 0 0 0 0 0 0 0 0 0 1 2 1 0 0 0
0 0 0 0 0 0 0 0 0 0 0 0 0 0 0 0 0 0 0 0 0 0 0 0 0 0 0 0 0 0 0 0 0 0 0 0 1 1 1 0 0 0
0 0 0 0 0 0 0 0 0 0 0 0 0 0 0 0 0 0 0 0 0 0 0 0 0 0 0 0 0 0 0 0 0 0 0 0 0 C 0 0 0 0
0 0 0 0 0 0 0 0 0 0 0 0 0 0 0 0 0 0 0 0 0 0 0 0 0 0 0 0 0 0 0 0 0 0 0 0 1 1 1 0 0 0
0 0 0 0 0 0 0 0 0 0 0 0 0 0 0 0 0 0 0 0 0 0 0 0 0 0 0 0 0 0 0 0 0 0 0 0 1 1 1 0 0 0
0 0 0 1 1 1 1 2 1 0 1 1 2 1 1 1 1 1 2 1 1 1 1 1 2 1 1 1 1 0 1 1 1 1 2 2 1 2 1 0 0 0
0 0 0 1 1 1 1 2 1 C 1 2 2 1 1 2 1 1 2 1 2 2 1 1 2 1 2 2 1 C 1 1 2 1 1 2 1 2 1 0 0 0
0 0 0 2 2 1 1 1 1 0 1 1 1 1 1 2 1 1 1 1 1 2 1 1 1 1 1 1 1 0 1 1 2 1 1 1 1 1 1 0 0 0
0 0 0 1 1 1 0 0 0 0 0 0 0 0 0 0 0 0 0 0 0 0 0 0 0 0 0 0 0 0 0 0 0 0 0 0 0 0 0 0 0 0
0 0 0 2 2 1 0 0 0 0 0 0 0 0 0 0 0 0 0 0 0 0 0 0 0 0 0 0 0 0 0 0 0 0 0 0 0 0 0 0 0 0
0 0 0 1 1 1 0 0 0 0 0 0 0 0 0 0 0 0 0 0 0 0 0 0 0 0 0 0 0 0 0 0 0 0 0 0 0 0 0 0 0 0
0 0 0 1 2 1 0 0 0 0 0 0 0 0 0 0 0 0 0 0 0 0 0 0 0 0 0 0 0 0 0 0 0 0 0 0 0 0 0 0 0 0
0 0 0 1 2 1 1 1 1 0 1 1 1 1 1 2 1 1 1 1 1 1 1 2 1 1 0 1 1 1 2 1 1 2 1 1 1 1 1 0 0 0
0 0 0 1 2 2 1 2 1 C 1 1 2 2 1 2 2 2 1 2 2 2 1 2 2 1 C 1 2 1 2 2 1 2 1 2 1 1 1 0 0 0
0 0 0 1 1 1 1 2 1 0 1 1 1 1 1 1 1 2 1 2 1 1 1 1 1 1 0 1 1 1 1 1 1 1 1 2 2 2 1 0 0 0
0 0 0 0 0 0 0 0 0 0 0 0 0 0 0 0 0 0 0 0 0 0 0 0 0 0 0 0 0 0 0 0 0 0 0 0 1 1 1 0 0 0
0 0 0 0 0 0 0 0 0 0 0 0 0 0 0 0 0 0 0 0 0 0 0 0 0 0 0 0 0 0 0 0 0 0 0 0 2 2 1 0 0 0
0 0 0 0 0 0 0 0 0 0 0 0 0 0 0 0 0 0 0 0 0 0 0 0 0 0 0 0 0 0 0 0 0 0 0 0 1 1 1 0 0 0
0 0 0 0 0 0 0 0 0 0 0 0 0 0 0 0 0 0 0 0 0 0 0 0 0 0 0 0 0 0 0 0 0 0 0 0 2 2 1 0 0 0
0 0 0 1 1 1 1 2 1 1 1 1 2 1 1 1 1 0 1 1 1 1 1 1 1 2 2 2 1 1 1 2 1 0 1 2 1 2 1 0 0 0
0 0 0 2 2 2 1 2 1 2 1 1 2 1 2 2 1 C 1 1 2 1 2 2 1 2 1 1 1 1 1 2 1 C 1 2 1 2 1 0 0 0
0 0 0 1 1 1 1 1 1 2 1 1 1 1 1 1 1 0 1 1 2 1 1 2 1 2 1 1 2 2 1 1 1 0 1 1 1 1 1 0 0 0
0 0 0 1 2 2 0 0 0 0 0 0 0 0 0 0 0 0 0 0 0 0 0 0 0 0 0 0 0 0 0 0 0 0 0 0 0 0 0 0 0 0
0 0 0 1 1 1 0 0 0 0 0 0 0 0 0 0 0 0 0 0 0 0 0 0 0 0 0 0 0 0 0 0 0 0 0 0 0 0 0 0 0 0
0 0 0 1 2 2 0 0 0 0 0 0 0 0 0 0 0 0 0 0 0 0 0 0 0 0 0 0 0 0 0 0 0 0 0 0 0 0 0 0 0 0
0 0 0 1 1 2 1 1 1 1 1 1 2 1 1 1 2 1 1 2 1 0 1 1 1 1 1 1 2 1 1 1 1 1 1 1 1 1 1 0 0 0
0 0 0 1 1 2 2 2 1 2 1 1 2 1 1 2 2 2 1 2 1 C 1 2 1 2 2 1 2 1 2 1 1 2 1 1 1 S 1 0 0 0
0 0 0 1 1 1 1 1 1 2 1 1 1 1 1 1 1 1 1 2 1 0 1 2 1 1 1 1 1 1 1 1 1 2 1 1 1 1 1 0 0 0
0 0 0 0 0 0 0 0 0 0 0 0 0 0 0 0 0 0 0 0 0 0 0 0 0 0 0 0 0 0 0 0 0 0 0 0 0 0 0 0 0 0
0 0 0 0 0 0 0 0 0 0 0 0 0 0 0 0 0 0 0 0 0 0 0 0 0 0 0 0 0 0 0 0 0 0 0 0 0 0 0 0 0 0
0 0 0 0 0 0 0 0 0 0 0 0 0 0 0 0 0 0 0 0 0 0 0 0 0 0 0 0 0 0 0 0 0 0 0 0 0 0 0 0 0 0
